111111111111111
1c00000200000b1
101212121212101
102200000002201
101210101012101
1222200~0022221
101210101012101
102200000002201
101212121212101
1a00000200000d1
111111111111111
