111111111111111
1c02222222220b1
101212121212101
122222222222221
121212101212121
1222220~0222221
121212101212121
122222222222221
101212121212101
1a02222222220d1
111111111111111
